GGGGGGGG
GRRRRGGG
GRGGRGGG
RRGGRGRR
GGGGRRRG
GGGGGGGG